###########################
#.........................#
#.........................#
#......####...............#
#.........................#
#.........................#
#.........................#
#.........................#
#.........................#
#..................########
#.........................#
#.........................#
#.........######..........#
#.........................#
#.........................#
#.........................#
#.........................#
#.........................#
#.............####........#
#.........................#
#.........................#
#.........................#
#...####..................#
#.........................#
#.........................#
#.........................#
###########################