####################################################
#..................................................#
#..................................................#
#......####........................................#
#..................................................#
#..................................................#
#..................................................#
#..................................................#
#..................................................#
#..................#######.........................#
#..................................................#
#..................................................#
#.........######...................................#
#..................................................#
#..................................................#
#..................................................#
#..................................................#
#..................................................#
#.............####.................................#
#..................................................#
#..................................................#
#..................................................#
#...####...........................................#
#..................................................#
#..................................................#
#..................................................#
#..................................................#
#..................................................#
#..................................................#
#..................................................#
#..................................................#
#..................................................#
#..................................................#
#..................................................#
#..................................................#
#..................................................#
####################################################